XXOOOOOOOOOXX
XXOXOXOXOXOXX
OOOOOOOOOOOOO
OXOXOXOXOXOXO
OOOOOOOOOOOOO
OXOXOXOXOXOXO
OOOOOOOOOOOOO
OXOXOXOXOXOXO
OOOOOOOOOOOOO
XXOXOXOXOXOXX
XXOOOOOOOOOXX
